  SO	./assets/south.xpm

     NO         ./assets/north.xpm

 WE ./assets/west.xpm




 EA ./assets/east.xpm

    F    30  ,  30  ,  30

 C	 240,155,34



1111111111111111111111111
1000000000000000000000001
1001111000111000000000001
1000001000001000000000001
1E00001000001000000000001
1001111000000000000000001
1000000000000000000000001
1000100010000000000000001
1111111111001000000000001
1111111111000000000000001
1111111111001000000000001
1111111111000000000000001
1100000000000000000000001
1000000000000000000000001
1111111111111111111111111
1000000000000000000000001
1000000000000000000000001
1000000000000000000000001
1001000100010000000000001
1000000000000000000000001
1000000000000000000000001
1000000000000000000000001
1111111111111111111111111



			 1
			101
		   10001
	1111111000001111111
   1110000000000000000011
  110000000000000000000001111
 100000000000000001111111111111
11100000000000001100000000000001
1011000000000000110000000000000011
10100000000000011000000000000000111
1010000000000001100000000000000011
10000000000000011000000000000111
1111100000000000011111111111111
11110000000000000000000000001
11110000000000000000000000001
11000000000000000000000000001
10000000000000000000000000001
10000000000000000001010000001
11000001110101011111011110001
11010000010001011000011010001
111111001111111111111111111111
	 100000011111111111
	 100000011111111111
	 110000011111111111
	 1100000000000111
	 1000000000011
	 1111111111111111
	 111111111111111111
	 11111111111111111111