
NO		./textures/wall2.xpm

SO		./textures/wall1.xpm

EA		./textures/wall2.xpm

WE		./textures/wall2.xpm

F	53, 94, 59

C	0, 0, 50


11111111111111111111111111111
10000000001100000000000011111
10110000011100000000000011111
10010000000000000000000011111
11111111101100000111000001111
10000000001100000111011000011
11110111111111011100000000001
11110111111111011101010000001
11000000110101011100000000001
10000000000000001100000010001
10000000000000001101010001001
11000001110101011111011110N01
11110111111101011101111010001
11111111111111111111111111111