
NO		./textures/wall2.xpm

SO		./textures/wall1.xpm

EA		./textures/wall2.xpm

WE		./textures/wall2.xpm

F	53, 94, 59

C	0, 0, 50


1111111111111111111111111
1000000000110000000000001
1011000001110000000000001
1001000000000000000000001
111111111011000001110000011111111
100000000011000001110110000111111
11110111111111011100000000001
11110111111111011101010000001
11000000110101011100000000001
10000000000000001100000010001
10000000000000001101010010001
11000001110101011111011110N0111
11110111111101011101111010001
11111111111111111111111111111