
SO		./assets/0.xpm

NO		./assets/0.xpm

WE		./assets/0.xpm




EA		./assets/0.xpm

F		30  ,  30  ,  30

C	 240, 155,34


        1111111111111111111111111
        1000000000110000000000001
        1011000001110000000000001
        1001000000000000000000001
111111111011000001110000000000001
100000000011000001110000000111111
11110111111111011100000000001
11110000000000011101010000001
11000000110101000000000000001
10000000000000000000000000001
10000000000000000001010000001
11000001110101011111011110N0111
11110111 1110101 101111010001
11111111 1111111 111111111111